total_number_messages_human;total_number_messages_agent;average_message_length_human;average_message_length_agent;ignored;workload;timePressure;taskSeverity;taskSwitch;occupiedTime;world_nr;tick_nr
0;0;0;0;0;0;0;0;0;0;1;0
0;0;0;0;0;0;0;0;0;0;1;1
0;1;0;0;0;0;0;0;0;0;1;2
0;1;0;0;0;0;0;0;0;0;1;3
0;1;0;0;0;0;0;0;0;0;1;4
0;1;0;0;0;0;0;0;0;0;1;5
0;1;0;0;0;0;0;0;0;0;1;6
0;1;0;0;0;0;0;0;0;0;1;7
0;1;0;0;0;0;0;0;0;0;1;8
0;1;0;0;0;0;0;0;0;0;1;9
0;1;0;0;0;0;0;0;0;0;1;10
0;1;0;0;0;0;0;0;0;0;1;11
0;1;0;0;0;0;0;0;0;0;1;12
0;2;0;0;0;0;0;0;0;0;1;13
0;2;0;0;0;0;0;0;0;0;1;14
0;2;0;0;0;0;0;0;0;0;1;15
0;2;0;0;0;0;0;0;0;0;1;16
0;2;0;0;0;0;0;0;0;0;1;17
0;2;0;0;0;0;0;0;0;0;1;18
0;2;0;0;0;0;0;0;0;0;1;19
0;2;0;0;0;0;0;0;0;0;1;20
0;2;0;0;0;0;0;0;0;0;1;21
0;2;0;0;0;0;0;0;0;0;1;22
0;2;0;0;0;0;0;0;0;0;1;23
0;2;0;0;0;0;0;0;0;0;1;24
1;2;0;0;0;0;0;0;0;0;1;25
1;2;0;0;0;0;0;0;0;0;1;26
1;3;0;0;0;0;0;0;0;0;1;27
1;3;0;0;0;0;0;0;0;0;1;28
1;3;0;0;0;0;0;0;0;0;1;29
1;3;0;0;0;0;0;0;0;0;1;30
1;3;0;0;0;0;0;0;0;0;1;31
1;3;0;0;0;0;0;0;0;0;1;32
1;3;0;0;0;0;0;0;0;0;1;33
1;3;0;0;0;0;0;0;0;0;1;34
1;3;0;0;0;0;0;0;0;0;1;35
1;3;0;0;0;0;0;0;0;0;1;36
1;3;0;0;0;0;0;0;0;0;1;37
1;3;0;0;0;0;0;0;0;0;1;38
1;3;0;0;0;0;0;0;0;0;1;39
1;3;0;0;0;0;0;0;0;0;1;40
1;3;0;0;0;0;0;0;0;0;1;41
1;3;0;0;0;0;0;0;0;0;1;42
1;3;0;0;0;0;0;0;0;0;1;43
1;3;0;0;0;0;0;0;0;0;1;44
1;4;0;0;0;0;0;0;0;0;1;45
1;4;0;0;0;0;0;0;0;0;1;46
1;4;0;0;0;0;0;0;0;0;1;47
1;4;0;0;0;0;0;0;0;0;1;48
1;4;0;0;0;0;0;0;0;0;1;49
1;4;0;0;0;0;0;0;0;0;1;50
1;4;0;0;0;0;0;0;0;0;1;51
1;4;0;0;0;0;0;0;0;0;1;52
1;4;0;0;0;0;0;0;0;0;1;53
1;5;0;0;0;0;0;0;0;0;1;54
1;5;0;0;0;0;0;0;0;0;1;55
1;5;0;0;0;0;0;0;0;0;1;56
1;5;0;0;0;0;0;0;0;0;1;57
1;5;0;0;0;0;0;0;0;0;1;58
1;5;0;0;0;0;0;0;0;0;1;59
1;5;0;0;0;0;0;0;0;0;1;60
1;5;0;0;0;0;0;0;0;0;1;61
1;5;0;0;0;0;0;0;0;0;1;62
1;5;0;0;0;0;0;0;0;0;1;63
1;5;0;0;0;0;0;0;0;0;1;64
1;5;0;0;0;0;0;0;0;0;1;65
1;5;0;0;0;0;0;0;0;0;1;66
1;5;0;0;0;0;0;0;0;0;1;67
1;5;0;0;0;0;0;0;0;0;1;68
1;5;0;0;0;0;0;0;0;0;1;69
1;5;0;0;0;0;0;0;0;0;1;70
1;5;0;0;0;0;0;0;0;0;1;71
1;5;0;0;0;0;0;0;0;0;1;72
1;5;0;0;0;0;0;0;0;0;1;73
1;5;0;0;0;0;0;0;0;0;1;74
1;5;0;0;0;0;0;0;0;0;1;75
1;5;0;0;0;0;0;0;0;0;1;76
1;5;0;0;0;0;0;0;0;0;1;77
1;5;0;0;0;0;0;0;0;0;1;78
1;5;0;0;0;0;0;0;0;0;1;79
1;5;0;0;0;0;0;0;0;0;1;80
1;5;0;0;0;0;0;0;0;0;1;81
1;5;0;0;0;0;0;0;0;0;1;82
1;5;0;0;0;0;0;0;0;0;1;83
