total_number_messages_human;total_number_messages_agent;average_message_length_human;average_message_length_agent;ignored;workload;timePressure;taskSeverity;taskSwitch;occupiedTime;world_nr;tick_nr
0;0;0;0;0;0;0;0;0;0;1;0
0;0;0;0;0;0;0;0;0;0;1;1
0;1;0;0;0;0;0;0;0;0;1;2
0;1;0;0;0;0;0;0;0;0;1;3
0;1;0;0;0;0;0;0;0;0;1;4
0;1;0;0;0;0;0;0;0;0;1;5
0;1;0;0;0;0;0;0;0;0;1;6
0;1;0;0;0;0;0;0;0;0;1;7
0;1;0;0;0;0;0;0;0;0;1;8
0;1;0;0;0;0;0;0;0;0;1;9
0;1;0;0;0;0;0;0;0;0;1;10
0;1;0;0;0;0;0;0;0;0;1;11
0;1;0;0;0;0;0;0;0;0;1;12
0;2;0;0;0;0;0;0;0;0;1;13
0;2;0;0;0;0;0;0;0;0;1;14
0;2;0;0;0;0;0;0;0;0;1;15
0;2;0;0;0;0;0;0;0;0;1;16
0;2;0;0;0;0;0;0;0;0;1;17
0;2;0;0;0;0;0;0;0;0;1;18
0;2;0;0;0;0;0;0;0;0;1;19
0;2;0;0;0;0;0;0;0;0;1;20
0;2;0;0;0;0;0;0;0;0;1;21
0;2;0;0;0;0;0;0;0;0;1;22
0;2;0;0;0;0;0;0;0;0;1;23
0;2;0;0;0;0;0;0;0;0;1;24
0;2;0;0;0;0;0;0;0;0;1;25
0;2;0;0;0;0;0;0;0;0;1;26
0;2;0;0;0;0;0;0;0;0;1;27
0;2;0;0;0;0;0;0;0;0;1;28
0;2;0;0;0;0;0;0;0;0;1;29
0;2;0;0;0;0;0;0;0;0;1;30
0;2;0;0;0;0;0;0;0;0;1;31
0;2;0;0;0;0;0;0;0;0;1;32
0;3;0;0;0;0;0;0;0;0;1;33
0;3;0;0;0;0;0;0;0;0;1;34
0;3;0;0;0;0;0;0;0;0;1;35
0;3;0;0;0;0;0;0;0;0;1;36
0;3;0;0;0;0;0;0;0;0;1;37
0;3;0;0;0;0;0;0;0;0;1;38
0;3;0;0;0;0;0;0;0;0;1;39
0;3;0;0;0;0;0;0;0;0;1;40
0;3;0;0;0;0;0;0;0;0;1;41
0;3;0;0;0;0;0;0;0;0;1;42
0;4;0;0;0;0;0;0;0;0;1;43
0;4;0;0;0;0;0;0;0;0;1;44
0;4;0;0;0;0;0;0;0;0;1;45
0;4;0;0;0;0;0;0;0;0;1;46
0;4;0;0;0;0;0;0;0;0;1;47
0;4;0;0;0;0;0;0;0;0;1;48
0;4;0;0;0;0;0;0;0;0;1;49
0;4;0;0;0;0;0;0;0;0;1;50
0;4;0;0;0;0;0;0;0;0;1;51
0;4;0;0;0;0;0;0;0;0;1;52
0;4;0;0;0;0;0;0;0;0;1;53
0;4;0;0;0;0;0;0;0;0;1;54
0;4;0;0;0;0;0;0;0;0;1;55
0;4;0;0;0;0;0;0;0;0;1;56
0;4;0;0;0;0;0;0;0;0;1;57
0;4;0;0;0;0;0;0;0;0;1;58
0;4;0;0;0;0;0;0;0;0;1;59
0;4;0;0;0;0;0;0;0;0;1;60
0;4;0;0;0;0;0;0;0;0;1;61
0;4;0;0;0;0;0;0;0;0;1;62
0;4;0;0;0;0;0;0;0;0;1;63
0;4;0;0;0;0;0;0;0;0;1;64
0;4;0;0;0;0;0;0;0;0;1;65
0;4;0;0;0;0;0;0;0;0;1;66
0;4;0;0;0;0;0;0;0;0;1;67
0;4;0;0;0;0;0;0;0;0;1;68
0;4;0;0;0;0;0;0;0;0;1;69
0;4;0;0;0;0;0;0;0;0;1;70
0;4;0;0;0;0;0;0;0;0;1;71
0;4;0;0;0;0;0;0;0;0;1;72
0;4;0;0;0;0;0;0;0;0;1;73
0;4;0;0;0;0;0;0;0;0;1;74
0;4;0;0;0;0;0;0;0;0;1;75
0;4;0;0;0;0;0;0;0;0;1;76
0;4;0;0;0;0;0;0;0;0;1;77
0;4;0;0;0;0;0;0;0;0;1;78
0;4;0;0;0;0;0;0;0;0;1;79
0;4;0;0;0;0;0;0;0;0;1;80
0;4;0;0;0;0;0;0;0;0;1;81
0;4;0;0;0;0;0;0;0;0;1;82
0;5;0;0;0;0;0;0;0;0;1;83
0;5;0;0;0;0;0;0;0;0;1;84
0;5;0;0;0;0;0;0;0;0;1;85
