total_number_messages_human;total_number_messages_agent;average_message_length_human;average_message_length_agent;ignored;workload;timePressure;taskSeverity;taskSwitch;occupiedTime;world_nr;tick_nr
0;0;0;0;0;0;0;0;0;0;1;0
0;0;0;0;0;0;0;0;0;0;1;1
0;1;0;0;0;0;0;0;0;0;1;2
0;1;0;0;0;0;0;0;0;0;1;3
0;1;0;0;0;0;0;0;0;0;1;4
0;1;0;0;0;0;0;0;0;0;1;5
0;1;0;0;0;0;0;0;0;0;1;6
0;1;0;0;0;0;0;0;0;0;1;7
0;1;0;0;0;0;0;0;0;0;1;8
0;1;0;0;0;0;0;0;0;0;1;9
0;1;0;0;0;0;0;0;0;0;1;10
0;1;0;0;0;0;0;0;0;0;1;11
0;1;0;0;0;0;0;0;0;0;1;12
0;2;0;0;0;0;0;0;0;0;1;13
0;2;0;0;0;0;0;0;0;0;1;14
0;2;0;0;0;0;0;0;0;0;1;15
0;2;0;0;0;0;0;0;0;0;1;16
0;2;0;0;0;0;0;0;0;0;1;17
0;2;0;0;0;0;0;0;0;0;1;18
0;2;0;0;0;0;0;0;0;0;1;19
0;2;0;0;0;0;0;0;0;0;1;20
0;2;0;0;0;0;0;0;0;0;1;21
0;2;0;0;0;0;0;0;0;0;1;22
0;2;0;0;0;0;0;0;0;0;1;23
0;2;0;0;0;0;0;0;0;0;1;24
0;2;0;0;0;0;0;0;0;0;1;25
0;2;0;0;0;0;0;0;0;0;1;26
0;2;0;0;0;0;0;0;0;0;1;27
0;2;0;0;0;0;0;0;0;0;1;28
0;2;0;0;0;0;0;0;0;0;1;29
0;2;0;0;0;0;0;0;0;0;1;30
0;2;0;0;0;0;0;0;0;0;1;31
0;2;0;0;0;0;0;0;0;0;1;32
0;3;0;0;0;0;0;0;0;0;1;33
0;3;0;0;0;0;0;0;0;0;1;34
0;3;0;0;0;0;0;0;0;0;1;35
0;3;0;0;0;0;0;0;0;0;1;36
0;3;0;0;0;0;0;0;0;0;1;37
0;3;0;0;0;0;0;0;0;0;1;38
0;3;0;0;0;0;0;0;0;0;1;39
0;3;0;0;0;0;0;0;0;0;1;40
0;3;0;0;0;0;0;0;0;0;1;41
0;3;0;0;0;0;0;0;0;0;1;42
0;4;0;0;0;0;0;0;0;0;1;43
0;4;0;0;0;0;0;0;0;0;1;44
0;4;0;0;0;0;0;0;0;0;1;45
0;4;0;0;0;0;0;0;0;0;1;46
0;4;0;0;0;0;0;0;0;0;1;47
0;4;0;0;0;0;0;0;0;0;1;48
0;4;0;0;0;0;0;0;0;0;1;49
0;4;0;0;0;0;0;0;0;0;1;50
0;4;0;0;0;0;0;0;0;0;1;51
0;4;0;0;0;0;0;0;0;0;1;52
0;4;0;0;0;0;0;0;0;0;1;53
0;4;0;0;0;0;0;0;0;0;1;54
0;4;0;0;0;0;0;0;0;0;1;55
0;4;0;0;0;0;0;0;0;0;1;56
0;4;0;0;0;0;0;0;0;0;1;57
0;4;0;0;0;0;0;0;0;0;1;58
0;4;0;0;0;0;0;0;0;0;1;59
0;4;0;0;0;0;0;0;0;0;1;60
0;4;0;0;0;0;0;0;0;0;1;61
0;4;0;0;0;0;0;0;0;0;1;62
0;4;0;0;0;0;0;0;0;0;1;63
0;4;0;0;0;0;0;0;0;0;1;64
0;4;0;0;0;0;0;0;0;0;1;65
0;4;0;0;0;0;0;0;0;0;1;66
0;4;0;0;0;0;0;0;0;0;1;67
0;4;0;0;0;0;0;0;0;0;1;68
0;4;0;0;0;0;0;0;0;0;1;69
0;4;0;0;0;0;0;0;0;0;1;70
0;4;0;0;0;0;0;0;0;0;1;71
0;4;0;0;0;0;0;0;0;0;1;72
0;4;0;0;0;0;0;0;0;0;1;73
0;4;0;0;0;0;0;0;0;0;1;74
0;4;0;0;0;0;0;0;0;0;1;75
0;4;0;0;0;0;0;0;0;0;1;76
0;4;0;0;0;0;0;0;0;0;1;77
0;4;0;0;0;0;0;0;0;0;1;78
0;4;0;0;0;0;0;0;0;0;1;79
0;4;0;0;0;0;0;0;0;0;1;80
0;4;0;0;0;0;0;0;0;0;1;81
0;4;0;0;0;0;0;0;0;0;1;82
0;5;0;0;0;0;0;0;0;0;1;83
0;5;0;0;0;0;0;0;0;0;1;84
0;5;0;0;0;0;0;0;0;0;1;85
0;5;0;0;0;0;0;0;0;0;1;86
0;5;0;0;0;0;0;0;0;0;1;87
0;5;0;0;0;0;0;0;0;0;1;88
0;5;0;0;0;0;0;0;0;0;1;89
0;5;0;0;0;0;0;0;0;0;1;90
0;5;0;0;0;0;0;0;0;0;1;91
0;5;0;0;0;0;0;0;0;0;1;92
0;5;0;0;0;0;0;0;0;0;1;93
0;5;0;0;0;0;0;0;0;0;1;94
0;5;0;0;0;0;0;0;0;0;1;95
0;5;0;0;0;0;0;0;0;0;1;96
0;5;0;0;0;0;0;0;0;0;1;97
0;5;0;0;0;0;0;0;0;0;1;98
0;5;0;0;0;0;0;0;0;0;1;99
0;5;0;0;0;0;0;0;0;0;1;100
0;5;0;0;0;0;0;0;0;0;1;101
0;5;0;0;0;0;0;0;0;0;1;102
0;5;0;0;0;0;0;0;0;0;1;103
0;5;0;0;0;0;0;0;0;0;1;104
0;5;0;0;0;0;0;0;0;0;1;105
0;5;0;0;0;0;0;0;0;0;1;106
0;5;0;0;0;0;0;0;0;0;1;107
0;5;0;0;0;0;0;0;0;0;1;108
0;5;0;0;0;0;0;0;0;0;1;109
0;5;0;0;0;0;0;0;0;0;1;110
0;5;0;0;0;0;0;0;0;0;1;111
0;5;0;0;0;0;0;0;0;0;1;112
0;5;0;0;0;0;0;0;0;0;1;113
0;5;0;0;0;0;0;0;0;0;1;114
0;5;0;0;0;0;0;0;0;0;1;115
0;5;0;0;0;0;0;0;0;0;1;116
0;5;0;0;0;0;0;0;0;0;1;117
0;5;0;0;0;0;0;0;0;0;1;118
0;5;0;0;0;0;0;0;0;0;1;119
0;5;0;0;0;0;0;0;0;0;1;120
0;5;0;0;0;0;0;0;0;0;1;121
0;5;0;0;0;0;0;0;0;0;1;122
0;5;0;0;0;0;0;0;0;0;1;123
0;5;0;0;0;0;0;0;0;0;1;124
0;5;0;0;0;0;0;0;0;0;1;125
0;5;0;0;0;0;0;0;0;0;1;126
0;5;0;0;0;0;0;0;0;0;1;127
0;5;0;0;0;0;0;0;0;0;1;128
0;5;0;0;0;0;0;0;0;0;1;129
0;5;0;0;0;0;0;0;0;0;1;130
0;5;0;0;0;0;0;0;0;0;1;131
0;5;0;0;0;0;0;0;0;0;1;132
0;6;0;0;0;0;0;0;0;0;1;133
0;6;0;0;0;0;0;0;0;0;1;134
0;6;0;0;0;0;0;0;0;0;1;135
0;6;0;0;0;0;0;0;0;0;1;136
0;6;0;0;0;0;0;0;0;0;1;137
0;6;0;0;0;0;0;0;0;0;1;138
0;6;0;0;0;0;0;0;0;0;1;139
0;6;0;0;0;0;0;0;0;0;1;140
0;6;0;0;0;0;0;0;0;0;1;141
0;6;0;0;0;0;0;0;0;0;1;142
0;6;0;0;0;0;0;0;0;0;1;143
0;6;0;0;0;0;0;0;0;0;1;144
0;6;0;0;0;0;0;0;0;0;1;145
0;6;0;0;0;0;0;0;0;0;1;146
0;6;0;0;0;0;0;0;0;0;1;147
0;6;0;0;0;0;0;0;0;0;1;148
0;6;0;0;0;0;0;0;0;0;1;149
0;6;0;0;0;0;0;0;0;0;1;150
0;6;0;0;0;0;0;0;0;0;1;151
0;6;0;0;0;0;0;0;0;0;1;152
0;6;0;0;0;0;0;0;0;0;1;153
0;6;0;0;0;0;0;0;0;0;1;154
0;6;0;0;0;0;0;0;0;0;1;155
0;6;0;0;0;0;0;0;0;0;1;156
0;6;0;0;0;0;0;0;0;0;1;157
0;6;0;0;0;0;0;0;0;0;1;158
0;6;0;0;0;0;0;0;0;0;1;159
0;6;0;0;0;0;0;0;0;0;1;160
0;6;0;0;0;0;0;0;0;0;1;161
0;6;0;0;0;0;0;0;0;0;1;162
0;6;0;0;0;0;0;0;0;0;1;163
0;6;0;0;0;0;0;0;0;0;1;164
0;6;0;0;0;0;0;0;0;0;1;165
0;6;0;0;0;0;0;0;0;0;1;166
0;6;0;0;0;0;0;0;0;0;1;167
0;6;0;0;0;0;0;0;0;0;1;168
0;6;0;0;0;0;0;0;0;0;1;169
